11111111111111111111
100000C10000000001C1
10011111000000000101
10000000000000000001
10000000000000000001
10000000000000000001
10000000000000000001
10000000111000000001
1P0011E01C0000000001
11111111111111111111
